
＊初期化
＄喋り間隔	180
＄喋り間隔誤差	5％
＄会話時サーフェス戻し	無効
＄自動挿入ウェイトタイプ	里々
＄自動挿入ウェイトの倍率	１００％
＄訪問日数	0
＄性別	未設定
＄一人称	私
＄なでられ時実行イベント	なでられ時の反応
＄出会い済	0
＄初回終了済	0
＄ユーザ	お客さん
＄ストーリー進行度	0
＄ストーリー進行フラグ	0
＄マウスホイールカウント	0
＄庭訪問済み	0
＄書斎訪問済み	0
＄終了時状態	通常
＄宿泊経験済	0
＄ユーザ読み	未入力
